32 32 32 32 32 32 32 32 32 32 32 32 32 32 32 32
32 32 32 32 32 32 32 32 32 32 32 32 32 32 32 32
32 2 2 2 2 2 2 2 2 2 2 2 2 2 32 32
32 2 20 21 21 21 22 2 2 2 2 2 2 2 32 32
32 2 23 18 18 18 24 2 2 2 2 2 2 2 2 2
32 2 23 18 18 18 24 2 2 2 2 2 2 2 2 2
32 2 23 18 18 18 24 2 2 2 2 2 2 2 2 2
32 2 25 26 26 26 27 2 2 2 2 2 2 2 2 2
32 2 2 2 2 2 2 2 2 2 2 2 2 2 32 32
32 2 2 2 2 2 2 2 2 2 2 2 2 2 32 32
32 32 32 32 32 32 32 32 32 32 32 32 32 32 32 32
32 32 32 32 32 32 32 32 32 32 32 32 32 32 32 32
